NO ./textures/Bricks.xpm
SO ./textures/Dirt.xpm
WE ./textures/Stones.xpm
EA ./textures/wall.xpm

C 220,0,150
F 210,210,150

        1111111111111111111111111
        1000000000110000000000001
        1011000001110000000000001
        1001000000000000000000001
111111111011000001110000000000001
100000000011000001110111111111111
11112111111111011100000010001
111100111111111011101010010001
11N00000110101011100000010001
10000000000000002000000010001
1000000000000011010100100011
11000001110101011111011110011
11110111 1110101 101111010001
11111111 1111111 1111111111111111111
