111111
10000111111111
10000011000001
10000011000001
10000011000001
10000000000001
11111111111111